{
  "id": "easy_01",
  "name": "Easy 01",
  "grid": [
    "############",
    "############",
    "############",
    "#####...G..#",
    "#####b######",
    "#S...g######",
    "############",
    "############"
  ],
  "solution": [
    "f0{",
    "right",
    "if_green+up",
    "if_blue+up",
    "}f0"
  ]
}
